000000000000000000000000000000
000000000000000000000000000000
000000000000000000000000000000
000000000000000000000000000000
000000000000000000000000000000
00000#####0000000000#####00000
00000#000000000000000000#00000
00000#000000000000000000#00000
00000#000000000000000000#00000
00000#000000000000000000#00000
000000000000000000000000000000
0000000000###0000###0000000000
0000000000#00000000#0000000000
0000000000#00000000#0000000000
000000000000000000000000000000
000000000000000000000000000000
000000000000000000000000000000
0000000000#00000000#0000000000
0000000000#00000000#0000000000
0000000000###0000###0000000000
000000000000000000000000000000
00000#000000000000000000#00000
00000#000000000000000000#00000
00000#000000000000000000#00000
00000#000000000000000000#00000
00000#####0000000000#####00000
000000000000000000000000000000
000000000000000000000000000000
000000000000000000000000000000
000000000000000000000000000000