000000000000000000000000000000
000000000000000000000000000000
000000000000000000000000000000
000000000000000000000000000000
000000000000000000000000000000
000000000000000000000000000000
000000000000000000000000000000
00000000##########000#00000000
00000000#000000000000#00000000
00000000#000000000000#00000000
00000000#000000000000#00000000
00000000#000000000000#00000000
00000000#000000000000#00000000
00000000#000000000000#00000000
000000000000000000000000000000
000000000000000000000000000000
000000000000000000000000000000
00000000#000000000000#00000000
00000000#000000000000#00000000
00000000#000000000000#00000000
00000000#000000000000#00000000
00000000#000000000000#00000000
00000000#000000000000#00000000
00000000#000##########00000000
000000000000000000000000000000
000000000000000000000000000000
000000000000000000000000000000
000000000000000000000000000000
000000000000000000000000000000
000000000000000000000000000000