0000000000000000000000000000000
0000000000000000000000000000000
0000000000000000000000000000000
0000##########000##########0000
0000#000000000000000000000#0000
0000#000000000000000000000#0000
0000#000000000000000000000#0000
0000#000###########000#000#0000
0000#000#0000000000000#000#0000
0000#000#0000000000000#000#0000
0000#000#0000000000000#000#0000
0000#000#0000000000000#000#0000
0000#000#0000000000000#000#0000
0000#000#0000000000000#000#0000
0000#000000000000000000000#0000
0000#000000000000000000000#0000
0000#000000000000000000000#0000
0000#000#0000000000000#000#0000
0000#000#0000000000000#000#0000
0000#000#0000000000000#000#0000
0000#000#0000000000000#000#0000
0000#000#0000000000000#000#0000
0000#000#0000000000000#000#0000
0000#000#000###########000#0000
0000#000000000000000000000#0000
0000#000000000000000000000#0000
0000#000000000000000000000#0000
0000##########000##########0000
0000000000000000000000000000000
0000000000000000000000000000000
0000000000000000000000000000000